,Make,N.Fatal.Crashes,N.Non.Fatal.Crashes,Total.Crashes,ratio.fatal.to.tot
0,Cessna,3508,122,3630,0.966
1,Piper,1635,60,1695,0.965
2,Boeing,726,512,1238,0.586
3,Beech,602,35,637,0.945
4,Air Tractor,438,10,448,0.978
5,Grumman,292,4,296,0.986
6,Airbus,164,124,288,0.569
7,Dougals,128,51,179,0.715
8,De Havilland,139,11,150,0.927
9,Embraer,114,27,141,0.809
10,Cirrus,131,6,137,0.956
11,Bombardier,99,24,123,0.805
12,Rockwell,81,4,85,0.953
13,Mooney,79,4,83,0.952
14,Aviat,72,5,77,0.935
15,Aero Commander,67,1,68,0.985
16,Bellanca,65,0,65,1.0
17,Ayres,53,2,55,0.964
18,Swearingen,42,6,48,0.875
19,Diamond Aircraft Ind Inc,46,1,47,0.979
20,Learjet,42,2,44,0.955
21,Aeronca,43,1,44,0.977
22,Ayres Corporation,41,0,41,1.0
23,Diamond,35,1,36,0.972
24,British Aerospace,22,11,33,0.667
25,Champion,32,0,32,1.0
26,Raytheon Aircraft Company,30,0,30,1.0
27,Maule,28,0,28,1.0
28,Fairchild,22,5,27,0.815
29,North American,26,1,27,0.963
30,Lockheed,21,6,27,0.778
31,Weatherly,25,0,25,1.0
32,Socata,24,1,25,0.96
33,Gulfstream,23,2,25,0.92
34,Mitsubishi,17,2,19,0.895
35,Schweizer Aircraft Corp,18,1,19,0.947
36,Vans,17,1,18,0.944
37,Luscombe,18,0,18,1.0
38,Rans,14,3,17,0.824
39,Atr,10,7,17,0.588
40,Stinson,16,0,16,1.0
41,Taylorcraft,16,0,16,1.0
42,Pilatus,13,3,16,0.812
43,Fokker,11,4,15,0.733
44,Wsk Pzl Mielec,15,0,15,1.0
45,Costruzioni Aeronautiche Tecna,15,0,15,1.0
46,Raytheon,14,1,15,0.933
47,Canadair,11,3,14,0.786
48,Flight Design Gmbh,14,0,14,1.0
49,Helio,14,0,14,1.0
50,Evektor-Aerotechnik As,13,0,13,1.0
51,Saab,10,3,13,0.769
52,American Champion Aircraft,12,0,12,1.0
53,Britten Norman,11,1,12,0.917
54,Eagle,12,0,12,1.0
55,Gulfstream Aerospace,10,2,12,0.833
56,Cub Crafters Inc,11,1,12,0.917
57,Thrush Aircraft Inc,11,1,12,0.917
58,Schweizer,11,0,11,1.0
59,Israel Aircraft Industries,11,0,11,1.0
60,Britten-Norman,10,0,10,1.0
61,Waco,10,0,10,1.0
62,Pitts,9,0,9,1.0
63,Curtiss Wright,9,0,9,1.0
64,Gulfstream-Schweizer A/C Corp,9,0,9,1.0
65,Convair,8,1,9,0.889
66,Learjet Inc,8,1,9,0.889
67,Embraer S A,7,2,9,0.778
68,Hawker,8,0,8,1.0
69,General Atomics,7,1,8,0.875
70,Lancair,8,0,8,1.0
71,Tecnam,8,0,8,1.0
72,Piaggio,8,0,8,1.0
73,Ercoupe,8,0,8,1.0
74,Gates Learjet Corp.,8,0,8,1.0
75,Gates Learjet,6,1,7,0.857
76,Gulfstream-Schweizer,7,0,7,1.0
77,Short Bros,7,0,7,1.0
78,Aircraft Mfg & Dev. Co. (Amd),7,0,7,1.0
79,Diamond Aircraft Industries,7,0,7,1.0
80,Snow,7,0,7,1.0
81,Robin,5,2,7,0.714
82,Zenith,6,1,7,0.857
83,Dassault-Breguet,6,0,6,1.0
84,Dassault,4,2,6,0.667
85,Reims,5,1,6,0.833
86,Hawker Siddeley,3,3,6,0.5
87,Remos Aircraft Gmbh,6,0,6,1.0
88,Embraer-Empresa Brasileira De,6,0,6,1.0
89,Saab-Scania Ab (Saab),3,3,6,0.5
90,Zenair,6,0,6,1.0
91,Quicksilver,6,0,6,1.0
92,Dornier,5,1,6,0.833
93,Cub Crafters,6,0,6,1.0
94,Flight Design,6,0,6,1.0
95,Great Lakes,6,0,6,1.0
96,American Legend Aircraft Co,6,0,6,1.0
97,Raytheon Corporate Jets,3,2,5,0.6
98,Antonov,3,2,5,0.6
99,Gulfstream American,3,2,5,0.6
100,Callair,5,0,5,1.0
101,Pilatus Aircraft Ltd,5,0,5,1.0
102,Smith,5,0,5,1.0
103,Lake,5,0,5,1.0
104,Aero Vodochody,5,0,5,1.0
105,Thrush,5,0,5,1.0
106,Diamond Aircraft Ind Gmbh,5,0,5,1.0
107,Gates Lear Jet,3,1,4,0.75
108,Gulfstream American Corp,3,1,4,0.75
109,Tl Ultralight Sro,4,0,4,1.0
110,Dassault/Sud,3,1,4,0.75
111,Canadair Ltd,4,0,4,1.0
112,Navion,4,0,4,1.0
113,Short Bros. & Harland,4,0,4,1.0
114,Czech Sport Aircraft As,4,0,4,1.0
115,Quest Aircraft Company Llc,4,0,4,1.0
116,Engineering & Research,4,0,4,1.0
117,Liberty Aerospace Incorporated,4,0,4,1.0
118,Avid,4,0,4,1.0
119,American Champion (Acac),4,0,4,1.0
120,Quest,4,0,4,1.0
121,Jabiru Usa Sport Aircraft Llc,4,0,4,1.0
122,Pzl Mielec,4,0,4,1.0
123,Siai-Marchetti,4,0,4,1.0
124,Classic Aircraft Corp,4,0,4,1.0
125,Yakovlev,4,0,4,1.0
126,Amateur Construction,4,0,4,1.0
127,Cassutt,4,0,4,1.0
128,Pipistrel,3,0,3,1.0
129,Aerovodochody,3,0,3,1.0
130,Remos,3,0,3,1.0
131,Extra Flugzeugproduktions-Und,3,0,3,1.0
132,Sukhoi,3,0,3,1.0
133,Steen,3,0,3,1.0
134,Quad City,3,0,3,1.0
135,Christen Industries Inc,3,0,3,1.0
136,Casa,2,1,3,0.667
137,Partenavia,2,1,3,0.667
138,Avro,1,2,3,0.333
139,Pacific Aerospace Corp Ltd,3,0,3,1.0
140,Hawker Aircraft Ltd,2,1,3,0.667
141,Extra,3,0,3,1.0
142,Just Aircraft Llc,3,0,3,1.0
143,Zivko Aeronautics Inc,3,0,3,1.0
144,Ryan,3,0,3,1.0
145,Zenair Ltd,3,0,3,1.0
146,Liberty Aerospace Inc.,3,0,3,1.0
147,Amateur Built Aircraft,3,0,3,1.0
148,Siai Marchetti,3,0,3,1.0
149,American,3,0,3,1.0
150,Avions Robin,3,0,3,1.0
151,Evektor Aerotechnik,3,0,3,1.0
152,Cubcrafters Inc,3,0,3,1.0
153,Short Brothers,3,0,3,1.0
154,Czech Aircraft Works Spol Sro,3,0,3,1.0
155,Czech Sport,2,0,2,1.0
156,Commander,2,0,2,1.0
157,"Thrush Aircraft, Inc.",2,0,2,1.0
158,Airplane Factory (Pty) Ltd,2,0,2,1.0
159,Moravan,2,0,2,1.0
160,Eagle Aircraft Co.,2,0,2,1.0
161,Stearman,2,0,2,1.0
162,Construcciones Aeronauticas Sa,2,0,2,1.0
163,North American/Aero Classics,2,0,2,1.0
164,"Wolseley Motors, Inc.",2,0,2,1.0
165,Found Acft Canada Inc,2,0,2,1.0
166,American Legend,2,0,2,1.0
167,Edge,2,0,2,1.0
168,Monocoupe,2,0,2,1.0
169,Daher,2,0,2,1.0
170,Mx Aircraft Llc,2,0,2,1.0
171,American Champion,2,0,2,1.0
172,Ayres Thrush,2,0,2,1.0
173,Aerospatiale,1,1,2,0.5
174,Gates Lear Jet Corp.,1,1,2,0.5
175,Honda Aircraft,1,1,2,0.5
176,Curtiss-Wright,2,0,2,1.0
177,Remos Acft Gmbh Flugzeugbau,2,0,2,1.0
178,Vans Aircraft Inc,2,0,2,1.0
179,Embraer S.A.,2,0,2,1.0
180,Iai,2,0,2,1.0
181,Fantasy Air,2,0,2,1.0
182,Varga,2,0,2,1.0
183,737,2,0,2,1.0
184,Icon Aircraft Inc,2,0,2,1.0
185,Dornier Gmbh,2,0,2,1.0
186,Zlin,2,0,2,1.0
187,Ercoupe (Eng & Research Corp.),2,0,2,1.0
188,Quickie,2,0,2,1.0
189,"Smith, Ted Aerostar",2,0,2,1.0
190,Jackson,2,0,2,1.0
191,Johnson,2,0,2,1.0
192,Honda Aircraft Co Llc,1,1,2,0.5
193,Ted Smith,2,0,2,1.0
194,Extra Flugzeugbau Gmbh,2,0,2,1.0
195,Gippsland,2,0,2,1.0
196,Let,2,0,2,1.0
197,Fpna Llc,2,0,2,1.0
198,Czech Aircraft Works,2,0,2,1.0
199,Republic,2,0,2,1.0
200,Liberty Aerospace,2,0,2,1.0
201,Glasair,2,0,2,1.0
202,Neiva,2,0,2,1.0
203,Grob-Werke,2,0,2,1.0
204,L-Bird Llc,2,0,2,1.0
205,Citabria,1,0,1,1.0
206,Wsk-Pzl Warzawa-Okecie,1,0,1,1.0
207,Bryan C L/Labrash R D,1,0,1,1.0
208,Airborne Windsports Ltd,1,0,1,1.0
209,Seibert Robert M,1,0,1,1.0
210,Stamper,1,0,1,1.0
211,Willerton,1,0,1,1.0
212,Diamond Aircraft,1,0,1,1.0
213,Airtime Aircraft Inc,1,0,1,1.0
214,Meriwether Jon,1,0,1,1.0
215,M7 Aerospace Llc,1,0,1,1.0
216,Saab-Scania,1,0,1,1.0
217,Kenneth B Hines,1,0,1,1.0
218,Socata-Groupe Aerospatiale,1,0,1,1.0
219,Paulistinha  56-C1,1,0,1,1.0
220,Lawrence O Nolte,1,0,1,1.0
221,Brown Joseph B Jr,1,0,1,1.0
222,Norman Negus,1,0,1,1.0
223,Christen Industries,1,0,1,1.0
224,Freeman Heritage Collection,1,0,1,1.0
225,Monnett,1,0,1,1.0
226,G-Dawg Llc,1,0,1,1.0
227,Dusenberry,1,0,1,1.0
228,Hiller,1,0,1,1.0
229,Schendl,1,0,1,1.0
230,C M Stuhrenberg/P C Polete,1,0,1,1.0
231,Chrapczynski,1,0,1,1.0
232,Murphy Aircraft,1,0,1,1.0
233,Comp Air Inc. (Plambeck),1,0,1,1.0
234,"Jabiru Usa Sport Aircraft, Llc",1,0,1,1.0
235,Suminski Walter M,1,0,1,1.0
236,Consolidated Aeronautics Inc.,1,0,1,1.0
237,League,1,0,1,1.0
238,Gulfstream Aerospace Corp,1,0,1,1.0
239,Iniziative,1,0,1,1.0
240,Yakovlev/Chinnery,1,0,1,1.0
241,Foster William D,1,0,1,1.0
242,Skybolt,1,0,1,1.0
243,Nihon,1,0,1,1.0
244,Boyd Bruce,1,0,1,1.0
245,Vicari,1,0,1,1.0
246,Mobi-Light,1,0,1,1.0
247,"Wrb Associates, Llc.",1,0,1,1.0
248,Aero Sp Z O O (Gobosh),1,0,1,1.0
249,Sorrell,1,0,1,1.0
250,Israel Aerospace Industriesltd,1,0,1,1.0
251,Roetman Ryland K Jr,1,0,1,1.0
252,Mercer,1,0,1,1.0
253,Conway Philip J,1,0,1,1.0
254,Brinker / Garner,1,0,1,1.0
255,Iniziative Industriali Italian,1,0,1,1.0
256,Tyler Ives,1,0,1,1.0
257,Rajhamsa,1,0,1,1.0
258,Mathis Melvin R,1,0,1,1.0
259,Grahn J/Grahn G,1,0,1,1.0
260,Avres Corp.,1,0,1,1.0
261,Bordelon,1,0,1,1.0
262,Frazier,1,0,1,1.0
263,Embraer Aircraft,1,0,1,1.0
264,Fairchild(Howard),1,0,1,1.0
265,Southern Airmotive Corp Sac,1,0,1,1.0
266,Dassault Falcon,1,0,1,1.0
267,Gulfstream Aerospace Corp.,1,0,1,1.0
268,Huntington,1,0,1,1.0
269,Yuneec,1,0,1,1.0
270,Hillery W. Grice,1,0,1,1.0
271,Aircraft Mfg & Development Co,1,0,1,1.0
272,Embraer Sa,1,0,1,1.0
273,Davis,1,0,1,1.0
274,Corvus,1,0,1,1.0
275,Silence,1,0,1,1.0
276,Lorentzen,1,0,1,1.0
277,Birchler Boyd,1,0,1,1.0
278,Wag-A-Bond Traveller,1,0,1,1.0
279,Blackshape,1,0,1,1.0
280,Fairchild Industries,1,0,1,1.0
281,Motley Gary W,1,0,1,1.0
282,Wilson,1,0,1,1.0
283,Liberty,1,0,1,1.0
284,Martin,1,0,1,1.0
285,Fantasy Air Sro,1,0,1,1.0
286,White,1,0,1,1.0
287,Amstutz Curtis J,1,0,1,1.0
288,Hillard Charlie R,1,0,1,1.0
289,Czech Sport Aircraft A S,1,0,1,1.0
290,English Electric Lightning,1,0,1,1.0
291,Pzl Okecie,1,0,1,1.0
292,Aerospatiale Alenia,1,0,1,1.0
293,Columbia Aircraft Mfg,1,0,1,1.0
294,Na,1,0,1,1.0
295,Wagaero,1,0,1,1.0
296,Aero Vodochody Aero. Works,1,0,1,1.0
297,Cavalier,1,0,1,1.0
298,Jurmu,1,0,1,1.0
299,Turbo Thrush,1,0,1,1.0
300,Jahns,1,0,1,1.0
301,Midget,1,0,1,1.0
302,Backovich George C,1,0,1,1.0
303,J.A.Mullan,1,0,1,1.0
304,Bender,1,0,1,1.0
305,C A S A,1,0,1,1.0
306,C A Tecnam Srl,1,0,1,1.0
307,Meyers,1,0,1,1.0
308,Waco Classic Aircraft,1,0,1,1.0
309,Sonex Limited,1,0,1,1.0
310,Brumbaugh David R,1,0,1,1.0
311,Fairchild Hiller,1,0,1,1.0
312,Progressive Aerodyne,1,0,1,1.0
313,Lockwood,1,0,1,1.0
314,Bosonetto,1,0,1,1.0
315,Kenney,1,0,1,1.0
316,Mileski,1,0,1,1.0
317,Consolidated Vultee,1,0,1,1.0
318,Airparts Nz Ltd,1,0,1,1.0
319,Extra Flugzeugbau,1,0,1,1.0
320,Aero At Sp Zoo,1,0,1,1.0
321,Beagle,1,0,1,1.0
322,Hogan,1,0,1,1.0
323,Dixon,1,0,1,1.0
324,Viking Air Limited,1,0,1,1.0
325,Dickson,1,0,1,1.0
326,Craig D Carter,1,0,1,1.0
327,Dacey,1,0,1,1.0
328,Raytheon Corporate Jets Inc,1,0,1,1.0
329,"Halderman, Floyd G.",1,0,1,1.0
330,Moyes,1,0,1,1.0
331,Aerofab,1,0,1,1.0
332,Farace Thomas Scott,1,0,1,1.0
333,Liberty Aerospace Incorporate,1,0,1,1.0
334,Peay,1,0,1,1.0
335,Andrews,1,0,1,1.0
336,Curtis,1,0,1,1.0
337,Tatelman-Pitts,1,0,1,1.0
338,Evektor Aerotechnik As,1,0,1,1.0
339,Evektor-Aerotechnik,1,0,1,1.0
340,Texas Air Ventures Inc,1,0,1,1.0
341,Sharp Ralph R,1,0,1,1.0
342,S.A.N.,1,0,1,1.0
343,Angel Aircraft Corporation,1,0,1,1.0
344,Fairchild Funk,1,0,1,1.0
345,Vickers,1,0,1,1.0
346,"Schweizer, N36289",1,0,1,1.0
347,Elmwood,1,0,1,1.0
348,Buckman,1,0,1,1.0
349,Lsa America Inc,1,0,1,1.0
350,Vertical Unlimited Llc,1,0,1,1.0
351,Piaggio Aero Industries Spa,1,0,1,1.0
352,Amorde,1,0,1,1.0
353,Indonesian Aerospace,1,0,1,1.0
354,Harms,1,0,1,1.0
355,Slingsby,1,0,1,1.0
356,Ang,1,0,1,1.0
357,Aerofab Inc,1,0,1,1.0
358,Truitt Peter,1,0,1,1.0
359,Weston,1,0,1,1.0
360,Roberts,1,0,1,1.0
361,James B. Taplin,1,0,1,1.0
362,Carlton M. Cadwell,1,0,1,1.0
363,Fritz Neumeyer,1,0,1,1.0
364,Aviocar Casa,1,0,1,1.0
365,Rutten Phil J,1,0,1,1.0
366,Lawwill Ted,1,0,1,1.0
367,Mcfarland Wm H,1,0,1,1.0
368,Epig,1,0,1,1.0
369,Arion Aircraft Llc,1,0,1,1.0
370,Pioneer,1,0,1,1.0
371,Ridge Lowell H,1,0,1,1.0
372,University Of Kansas,0,1,1,0.0
373,Sutphin John E,0,1,1,0.0
374,Pepperd Greg J,0,1,1,0.0
375,Sorrel,0,1,1,0.0
376,Marquart,0,1,1,0.0
377,777,0,1,1,0.0
378,Aficionado,0,1,1,0.0
379,Harbin,0,1,1,0.0
380,Columbia,0,1,1,0.0
381,Gulfstream Aerospace Lp,0,1,1,0.0
382,Facebook Uk Ltd,0,1,1,0.0
383,British Aerospace Civil Aircr,0,1,1,0.0
384,Kitfox,0,1,1,0.0
385,Short Brothers & Harland Ltd.,0,1,1,0.0
386,Saab-Scania Ab,0,1,1,0.0
387,Kaman,0,1,1,0.0
388,Roach Neil,1,0,1,1.0
389,Nunn,0,1,1,0.0
390,Raytheon Co,0,1,1,0.0
391,Piaggio Industrie,0,1,1,0.0
392,Short Bros.,0,1,1,0.0
393,Fairchild/Swearingen,0,1,1,0.0
394,Bac,0,1,1,0.0
395,Von Berg,1,0,1,1.0
396,Lavia Argentina,1,0,1,1.0
397,Krueger,1,0,1,1.0
398,Central Ohio Dragonfly Club,1,0,1,1.0
399,Chang,1,0,1,1.0
400,Aerosport Ltd,1,0,1,1.0
401,Morrison,1,0,1,1.0
402,Downer Aircraft Industries,1,0,1,1.0
403,Cross-Capps,1,0,1,1.0
404,Bruce E. Hotz,1,0,1,1.0
405,Cosmos,1,0,1,1.0
406,Ely,1,0,1,1.0
407,Ag-Cat Corporation,1,0,1,1.0
408,Cassult Racer,1,0,1,1.0
409,Fairley Gooch,1,0,1,1.0
410,Fox Jack G,1,0,1,1.0
411,Hopkins,1,0,1,1.0
412,Evektor,1,0,1,1.0
413,Gallagher,1,0,1,1.0
414,S.O.C.A.T.A.,1,0,1,1.0
415,Lyons,1,0,1,1.0
416,Wright B Flyer Inc,1,0,1,1.0
417,Aerostar Acft Corp Of Texas,1,0,1,1.0
418,Ttx Air Llc,1,0,1,1.0
419,Airplane Factory,1,0,1,1.0
420,Bell,1,0,1,1.0
421,Northrop,1,0,1,1.0
422,Rivers Lindsey Lee,1,0,1,1.0
423,Mxr Technologies Inc,1,0,1,1.0
424,Cozy,1,0,1,1.0
425,Bordiuk,1,0,1,1.0
426,Frederick,1,0,1,1.0
427,Hall Terrence / Hall Cathie,1,0,1,1.0
428,Costruzioni Aeronautiche,1,0,1,1.0
429,Saville Hummer,1,0,1,1.0
430,M-Squared Aircraft,1,0,1,1.0
431,Evolution 19,1,0,1,1.0
432,Edson Robert W,1,0,1,1.0
433,Luciani,1,0,1,1.0
434,Cook,1,0,1,1.0
435,Sorenson,1,0,1,1.0
436,Nord,1,0,1,1.0
437,Thorp,1,0,1,1.0
438,Ogg Richard A,1,0,1,1.0
439,Jm Kemp,1,0,1,1.0
440,Stampe Renard,1,0,1,1.0
441,Titan,1,0,1,1.0
442,Davis Daniel T,1,0,1,1.0
443,Eipper,1,0,1,1.0
444,Dayton-Wright,1,0,1,1.0
445,Schupp Edward W,1,0,1,1.0
446,Sauer,1,0,1,1.0
447,Quartz Mountain Aerospace,1,0,1,1.0
448,Gordon Scot A,1,0,1,1.0
449,Nolin,1,0,1,1.0
450,Hitchcock,1,0,1,1.0
451,Marino,1,0,1,1.0
452,Wright Daniel J,1,0,1,1.0
453,Partenavia Spa,1,0,1,1.0
454,Velocity,1,0,1,1.0
455,Eclipse Aerospace Inc,1,0,1,1.0
456,North Wing,1,0,1,1.0
457,Kelly,1,0,1,1.0
458,Pietsch,1,0,1,1.0
459,Rans Aircraft,1,0,1,1.0
460,Classic Aircraft Corp.,1,0,1,1.0
461,Aircraft Mfg & Dev. Co.,1,0,1,1.0
462,Richard,1,0,1,1.0
463,Tifft,1,0,1,1.0
464,Hubbell,1,0,1,1.0
465,Auman Jl,1,0,1,1.0
466,Airvan,1,0,1,1.0
467,Ferguson William C,1,0,1,1.0
468,Hermann Bjorn,1,0,1,1.0
469,Mccurdy,1,0,1,1.0
470,Wsk-Pzl Meilec,1,0,1,1.0
471,Comco Ikarus,1,0,1,1.0
472,Warth Dennis J,1,0,1,1.0
473,Raven Aircraft Corppration,1,0,1,1.0
474,Nasa Ames Research Center,1,0,1,1.0
475,Aermacchi,1,0,1,1.0
476,American Eurocopter,1,0,1,1.0
477,Sabreliner Corp.,1,0,1,1.0
478,Giboney,1,0,1,1.0
479,Wag-Aero,1,0,1,1.0
480,New Kolb Aircraft Co Llc,1,0,1,1.0
481,Bedecorp Llc,1,0,1,1.0
482,Fairchild Heli-Porter,1,0,1,1.0
483,Cobalt Aircraft Industries Inc,1,0,1,1.0
484,Sorensen,1,0,1,1.0
485,Pac,1,0,1,1.0
486,Legacy,1,0,1,1.0
487,Aerotek,1,0,1,1.0
488,Kolb,1,0,1,1.0
489,Donald Bernard Higgs,1,0,1,1.0
490,Shook,1,0,1,1.0
491,Ayres Corp,1,0,1,1.0
492,Dauntless,1,0,1,1.0
493,Goodyear,1,0,1,1.0
494,Volmer Aircraft,1,0,1,1.0
495,Grob Aircraft Ag,1,0,1,1.0
496,Clamar Floats Inc,1,0,1,1.0
497,United Consultants,1,0,1,1.0
498,Randall Marvin L,1,0,1,1.0
499,Dta Sari,1,0,1,1.0
500,Diamond Aircraft Industries In,1,0,1,1.0
501,Rutan,1,0,1,1.0
502,Amd,1,0,1,1.0
503,Kitty Hawk,1,0,1,1.0
504,Q-Berry,1,0,1,1.0
505,Grob,1,0,1,1.0
506,Mkii Corporation,1,0,1,1.0
507,Avions Mudry Et Cie,1,0,1,1.0
508,Bobbi Boucher,1,0,1,1.0
509,Hrosik Gene,1,0,1,1.0
510,Challenger,1,0,1,1.0
511,Price,1,0,1,1.0
512,Sachse Stephan,1,0,1,1.0
513,British Aircraft Corp.,1,0,1,1.0
514,Seguin,1,0,1,1.0
515,"Nichols Rans, Inc.",1,0,1,1.0
516,M.C. Thomas,1,0,1,1.0
517,Lavia Argentina S.A.,1,0,1,1.0
518,Cubcrafters,1,0,1,1.0
519,Owen,1,0,1,1.0
520,Keesler,1,0,1,1.0
521,Mcdaniels,1,0,1,1.0
522,Noorduyn,1,0,1,1.0
523,Wsl Pzl,1,0,1,1.0
524,Kolb Company,1,0,1,1.0
525,Bkf,1,0,1,1.0
526,Waco Classic Aircraft Corp,1,0,1,1.0
527,Aeropro Cz S R O,1,0,1,1.0
528,Pzl-Mielec,1,0,1,1.0
529,Zodiac,1,0,1,1.0
530,Molino Oy,1,0,1,1.0
531,Coot,1,0,1,1.0
532,Brm Aero,1,0,1,1.0
533,Bowles Chris,1,0,1,1.0
534,Merritt Leslie R,1,0,1,1.0
535,Liteflite Pty Ltd,1,0,1,1.0
536,Skykits Corp,1,0,1,1.0
537,Embraer Executive Aircraft Inc,1,0,1,1.0
538,Michael Adamczyk,1,0,1,1.0
539,Comp Air,1,0,1,1.0
540,Artic Aircraft Corp.,1,0,1,1.0
541,Nickel,1,0,1,1.0
542,Silvaire,1,0,1,1.0
543,Forisch Edward,1,0,1,1.0
544,Capella,1,0,1,1.0
545,Trudel,1,0,1,1.0
546,Ryan Aeronautical,1,0,1,1.0
547,Potez-Air Fouga,1,0,1,1.0
548,Tupolev,1,0,1,1.0
549,Fisher,1,0,1,1.0
550,Supermarine,1,0,1,1.0
551,"Rhoads, Larry E",1,0,1,1.0
552,Evektor Aerotechnic,1,0,1,1.0
553,Hickham,1,0,1,1.0
554,Extra Flugzeugproduktions-Gmbh,1,0,1,1.0
555,Stits Flut-R-Bug,1,0,1,1.0
556,Arctic,1,0,1,1.0
557,Aerotechnik,1,0,1,1.0
558,Ultramagic Sa,1,0,1,1.0
559,Rand,1,0,1,1.0
560,Schoepflin,1,0,1,1.0
561,Ac Mfg & Dev'T Co,1,0,1,1.0
562,Rans Inc.,1,0,1,1.0
563,Airborne,1,0,1,1.0
564,Osprey 2,1,0,1,1.0
565,Flugzeugproduktions-Und Vertri,1,0,1,1.0
566,Stol Aircraft Corp,1,0,1,1.0
567,Acroduster,1,0,1,1.0
568,Fisher Flying Products,1,0,1,1.0
569,Remos Aircraft Gmbh Flugzeugba,1,0,1,1.0
570,Raf,1,0,1,1.0
571,James A Gray,1,0,1,1.0
572,Halbrook,1,0,1,1.0
573,Paradise Aircraft Usa Llc,1,0,1,1.0
574,British Aircraft Corp,1,0,1,1.0
575,Volksplane,1,0,1,1.0
576,Murray,1,0,1,1.0
577,Porterfield,1,0,1,1.0
578,Underland/Grothe/Finstrom,1,0,1,1.0
579,Glenn H Curtiss Museum,1,0,1,1.0
580,Forster,1,0,1,1.0
581,Bereznak,1,0,1,1.0
582,Spackman,1,0,1,1.0
583,Foxworthy Rick A,1,0,1,1.0
584,Mitchell,1,0,1,1.0
585,Spezio,1,0,1,1.0
586,Sadler,1,0,1,1.0
587,Nasdalla,1,0,1,1.0
588,Evans Aircraft,1,0,1,1.0
589,Jihlavan Airplanes Sro,1,0,1,1.0
590,Jabiru Aircraft Pty Ltd,1,0,1,1.0
591,S D Martin,1,0,1,1.0
592,Mayo,1,0,1,1.0
593,Rogers Kenneth J,1,0,1,1.0
594,Mas Events,1,0,1,1.0
595,Shannon James A Jr,1,0,1,1.0
596,Vashon Aircraft,1,0,1,1.0
597,Pitts Aerobatics,1,0,1,1.0
598,Refling,1,0,1,1.0
599,Lyman Randall/Scott David,1,0,1,1.0
600,Rogers,1,0,1,1.0
601,Merian Richard F,1,0,1,1.0
602,Pridmore,1,0,1,1.0
603,Joby Aero Inc,1,0,1,1.0
604,Mxr Technologies,1,0,1,1.0
605,Aircraft Mfg & Design Llc,1,0,1,1.0
606,Tomisin Thomas J,1,0,1,1.0
607,Spitfire,1,0,1,1.0
608,Hansen,1,0,1,1.0
609,Quest Aircraft Company,1,0,1,1.0
610,Thompson,1,0,1,1.0
611,Raytheon Company,1,0,1,1.0
612,Interstate,1,0,1,1.0
613,Adkins,1,0,1,1.0
614,Board James A,1,0,1,1.0
615,Fairchild Swearingen,1,0,1,1.0
616,Cruiser,1,0,1,1.0
617,Klaas Development Inc,1,0,1,1.0
618,Hallbauer,1,0,1,1.0
619,Arnold,1,0,1,1.0
620,Ferguson Aircraft,1,0,1,1.0
621,Icon,1,0,1,1.0
622,Curtis-Wright,1,0,1,1.0
623,Palen,1,0,1,1.0
624,Gulfstream Schweizer A/C Corp,1,0,1,1.0
625,Believer,1,0,1,1.0
626,Gulfstream Am Corp Comm Div,1,0,1,1.0
627,Aerostar S A,1,0,1,1.0
628,"Wingtip To Wingtip, Llc",1,0,1,1.0
629,Whittman,1,0,1,1.0
630,Crawford,1,0,1,1.0
631,Wells John L Jr,1,0,1,1.0
632,Sport Flight,1,0,1,1.0
633,Airplane Factory (Pty) Ltd The,1,0,1,1.0
634,Crow,1,0,1,1.0
635,Aero-Ace,1,0,1,1.0
636,"Allied Ag Cat Productions, Inc",1,0,1,1.0
637,Indy Aircraft Ltd,1,0,1,1.0
638,Gulfstream American Corp.,1,0,1,1.0
639,Piaggio Aero Industries S.P.A.,1,0,1,1.0
640,Hoyle,1,0,1,1.0
641,Skykits Corporation,1,0,1,1.0
642,Supinski Mark R,1,0,1,1.0
643,Eagle Aircraft Co,1,0,1,1.0
644,Wells Elgin M,1,0,1,1.0
645,Diamond Aircraft Industry Inc,1,0,1,1.0
646,Honda,1,0,1,1.0
647,Rotherwick Hr,1,0,1,1.0
648,Amature Built,1,0,1,1.0
649,Andrew Mckimmon,1,0,1,1.0
650,Bushmaster,1,0,1,1.0
651,Robertson,1,0,1,1.0
652,Gippsaero Pty Ltd,1,0,1,1.0
653,Ronald J Bender,1,0,1,1.0
654,Doggett Jack,1,0,1,1.0
655,Titan Aerospace Holdings Inc,1,0,1,1.0
656,Greg Connell,1,0,1,1.0
657,Mustang,1,0,1,1.0
658,Adolphson,1,0,1,1.0
659,Ostertag Walter G,1,0,1,1.0
660,Brown Mark,1,0,1,1.0
661,Morane-Saulnier,1,0,1,1.0
662,Brm Aero Sro,1,0,1,1.0
663,Softex Invest Llc,1,0,1,1.0
664,Pearson,1,0,1,1.0
665,Lankenau,1,0,1,1.0
666,Jewett,1,0,1,1.0
667,Eads Socata,1,0,1,1.0
668,Wag Aero,1,0,1,1.0
669,Czech Sport Aircraft,1,0,1,1.0
670,Scheineman-Van Buren,1,0,1,1.0
671,Universal Stinson,1,0,1,1.0
672,Air Creation,1,0,1,1.0
673,Storm Fury,1,0,1,1.0
674,Belcher,1,0,1,1.0
675,Ludwig Larry E,1,0,1,1.0
676,North American/Schwamm,1,0,1,1.0
677,Xtremeair Gmbh,1,0,1,1.0
678,"Weaver, David A",1,0,1,1.0
679,Erick Magno & Assoc Pa,1,0,1,1.0
680,Bristell,1,0,1,1.0
681,Smith Albert F,1,0,1,1.0
682,American Champion Aircraft Cor,1,0,1,1.0
683,Miller,1,0,1,1.0
684,Howard Steven C,1,0,1,1.0
685,Oliver Lawrence R,1,0,1,1.0
686,Ingraham,1,0,1,1.0
687,Joplin,1,0,1,1.0
688,Tandem,1,0,1,1.0
689,Klemme William H,1,0,1,1.0
690,Schaffer Gary W,1,0,1,1.0
691,Vulcanair,1,0,1,1.0
692,Millhouse D Scott,1,0,1,1.0
693,Rose Herbert D,1,0,1,1.0
694,Ilyushin,1,0,1,1.0
695,Velocity Inc,1,0,1,1.0
696,Schumacher,1,0,1,1.0
697,Unknown,1,0,1,1.0
698,Halladay Roy,1,0,1,1.0
699,M7 Aerospace,1,0,1,1.0
700,Short,1,0,1,1.0
701,Pilatus Britten-Norman,1,0,1,1.0
702,Gates Learjet Corporation,1,0,1,1.0
703,Aveko Sro,1,0,1,1.0
704,William K. Crawford,1,0,1,1.0
705,Helton,1,0,1,1.0
706,Kuykendall Charles,1,0,1,1.0
707,Zenith Acft Co,1,0,1,1.0
708,Smith Aerostar,1,0,1,1.0
709,Hansen Ib C,1,0,1,1.0
710,Baker Victor R,1,0,1,1.0
711,Lepow David A,1,0,1,1.0
712,Rainbow Sky Reach,1,0,1,1.0
713,Mudry,1,0,1,1.0
714,Aeropro Cz,1,0,1,1.0
715,Gates Learjet Corp,1,0,1,1.0
716,Little Eagle,1,0,1,1.0
717,Mudge Ray,1,0,1,1.0
718,Rice Leo B,1,0,1,1.0
719,3Xtrim,1,0,1,1.0
720,Moses Tim C,1,0,1,1.0
721,Roberto P. Garcia,1,0,1,1.0
722,Doshier Wilbert A,1,0,1,1.0
723,Globe,1,0,1,1.0
724,York,1,0,1,1.0
725,Maule Aircraft Corp,1,0,1,1.0
726,Whitehead,1,0,1,1.0
727,Thrush Aircraft Llc,1,0,1,1.0
728,Hoover David,1,0,1,1.0
729,M7Aero,1,0,1,1.0
730,Cornell W F/Sahakian J A Jr,1,0,1,1.0
731,Kevin D. Yarnevich,1,0,1,1.0
732,Sons Mustang,1,0,1,1.0
733,Taylor,1,0,1,1.0
734,Goudie,1,0,1,1.0
735,Progressive Aerodyne Inc,1,0,1,1.0
736,Schmidt Albert D,1,0,1,1.0
737,Nakajima,1,0,1,1.0
738,Brown Joseph,1,0,1,1.0
739,Lee Kolb,1,0,1,1.0
740,Aeros,1,0,1,1.0
741,Foxair Llc,1,0,1,1.0
742,Griffiths James Sydney,1,0,1,1.0
743,Stephen J Hoffman,0,1,1,0.0
